,Variable_Name,Information_Value,Random_Forest,Recursive_Feature_Elimination,Extra_Trees,Chi_Square,L_One,Votes
1,poutcome,1,1,1,1,1,1,6
2,month,1,1,1,1,1,1,6
6,job,1,1,1,1,1,1,6
0,duration,1,1,0,1,1,1,5
3,contact,1,0,1,0,1,1,4
4,pdays,1,1,0,0,1,0,3
7,housing,1,0,1,0,1,0,3
12,age,0,1,0,1,0,1,3
14,day,0,1,0,1,0,1,3
5,previous,1,0,0,0,1,0,2
8,balance,0,1,0,1,0,0,2
13,campaign,0,0,0,1,0,1,2
9,loan,0,0,1,0,0,0,1
10,marital,0,0,1,0,0,0,1
11,education,0,0,1,0,0,0,1
15,default,0,0,0,0,0,0,0
